  ███████████████████████████████████████
        █   █ █   █ █ █     █ █       █ █
███ █ █ █ █ █ █ ███ █ ███ █ █ ███ █ ███ █
█   █ █   █   █ █   █     █     █ █ █ █ █
███ ███ █████ █ █ ███████ █████████ █ █ █
█ █ █     █   █     █                   █
█ ███ █ ███████ █ █████████ █████ █████ █
█   █ █         █     █       █   █   █ █
█ ███ █████ █████ ███████ ███████ ███ ███
█ █   █ █ █   █ █   █ █       █     █ █ █
█ █ █ █ █ █ ███ █ ███ █ █████████ █ █ █ █
█   █   █   █           █   █     █   █ █
█ █ █ █ ███ ███████████ ███ ███████ ███ █
█ █ █ █   █   █       █         █       █
█ ███ ███ █ █ █ █████ ███ █ ███ ███████ █
█ █     █   █ █ █   █ █ █ █ █       █ █ █
█ █████████ ███ █ █ ███ █████ ███ ███ █ █
█     █           █   █     █   █       █
█ █████████ ███ ███████ ███ █ ███ █ █████
█     █     █     █ █   █   █   █ █     █
█ █ ███████ █ █ ███ ███████ █ █████ █ ███
█ █   █ █     █   █   █       █ █   █   █
█ █████ ███ █ █████ ███████ ███ █████ █ █
█   █     █ █ █ █     █         █   █ █ █
█████ ███████ █ █ █ ███ █ █ ███████ ███ █
█   █ █     █     █   █ █ █ █   █       █
███ █ ███ █ ███ █ █ █████ █ █ ███████ ███
█ █       █ █ █ █ █ █ █ █ █         █ █ █
█ █ █████ ███ █████ █ █ ███ ███ ███ █ █ █
█     █ █ █   █ █       █     █ █       █
█ █ ███ █ ███ █ ███ ███ █ █ █ ███ ███ █ █
█ █   █     █ █     █     █ █ █     █ █ █
███ █████ ███ █████ █████ █████████ █████
█   █   █     █ █     █ █   █   █       █
█ █████ ███ █ █ ███████ █ █ █ ███ █ █████
█ █     █ █ █     █   █   █   █   █     █
█ █ ███ █ ███████ █ █████ ███ █████ ███ █
█ █ █ █ █   █   █     █     █ █     █ █ █
█ █ █ █ ███ █ ███ █ ███ █ ███ █ ███ █ █ █
█     █           █     █ █     █   █   
███████████████████████████████████████ 
