  ███████████████████████████████████████████████████████████
                      █ █     █ █               █   █       █
█ █████ ███ █ █ █ ██ ██ █ ███ █ █ ███ ███ ███ █ █ ███ ███ █ █
█     █ █ █ █ █ █ █   █ █ █     █ █     █ █   █   █     █ █ █
█ █████ █ █ ███ █████ █ █ █████ ███████ ███ ███████████ ███ █
█ █ █ █ █ █   █   █ █         █ █         █           █ █   █
███ █ ███ █ █████ █ ███ █ █████ ███ ██ ████ █████ █████ ███ █
█ █       █ █   █ █   █ █   █ █   █ █   █   █   █     █ █ █ █
█ █ █ ███ █ █ ███ █ █████ █ █ █ ███ ███ █ █████ █████ █ █ ███
█   █ █ █   █ █       █   █     █     █     █ █   █         █
███████ █ █ █ ███ ███ ███ ███ █ █ ███████ ███ ███ ███ ███ █ █
█ █       █ █   █ █     █ █   █ █ █ █ █ █ █       █     █ █ █
█ █ █████ ███ ███ █████ █ ███ █████ █ █ █ █████ █ ███████ ███
█   █             █ █ █     █   █         █ █   █     █ █   █
███████ █ █ █ █ ███ █ █ █████ █ ████ ██ ███ █ ███████ █ █ ███
█       █ █ █ █   █   █ █     █   █   █ █       █   █   █   █
███ █████ ███ █ █ ███ █ ███████ █ █ ███ ███ ███ ███ █████ █ █
█     █ █ █ █ █ █     █   █ █ █ █ █   █       █ █         █ █
█ █ █ █ ███ █ █████ █ ███ █ █ █ ███ █ ███ █ ███ █ █████ ███ █
█ █ █   █     █   █ █ █     █ █ █   █     █ █     █ █ █ █   █
███ ███ █████ █ █ ███ █ █████ █ █ ███████ ███████ █ █ █████ █
█   █ █     █ █ █     █   █       █             █ █     █   █
█ █ █ ███ █ █████████ █████ █████ █ ███ █ ███████ ███ ███ ███
█ █   █   █   █     █ █ █   █ █   █ █   █   █     █     █   █
█ █ █ █ █ █ █ █ ███ ███ ███ █ █ ███ ███ █ ███ █████ █ █ █ ███
█ █ █   █ █ █ █ █         █   █     █   █     █   █ █ █ █   █
█ █████████ █   █████ █ ███ █████ ███ ███ █████ ███ ███ ███ █
█     █     █ █     █ █     █ █ █   █   █ █ █   █     █     █
█ █████████ █ █ ███ █████ ███ █ ███████ ███ █ █████████ █████
█ █ █   █ █   █   █   █               █ █     █       █     █
█ █ █ ███ █ ███ █ █ ███ ███ ███████████ ███ █████ ███████████
█   █       █   █ █   █ █   █ █ █   █ █     █   █     █ █   █
█ █ █████ ███ █ ███ █ ███ █ █ █ █ ███ ███ █ ███ █ █████ █ █ █
█ █     █ █   █ █ █ █ █   █ █     █ █ █ █ █     █   █     █ █
█████ ███ █ █ ███ █ █ █████ █ █ ███ █ █ █████ ███ ███ █████ █
█     █   █ █     █ █         █   █       █ █ █ █   █   █   █
███ ███ █ █ ███████ █ █ █ ███ █████ █ ███ █ █ █ ███ █ ███ █ █
█ █ █   █ █   █     █ █ █ █ █   █   █ █ █   █ █ █ █ █   █ █ █
█ █ █ █ █ ███████ █████ ███ █ ███ █████ ███ █ █ █ █ █ ███████
█   █ █ █       █ █ █   █     █     █   █ █   █ █     █   █ █
███ █ ███████ █ ███ █ █████ ███████ █ █ █ █ ███ █ ███ ███ █ █
█ █ █   █     █   █           █       █ █           █   █ █ █
█ █ █ █ █████████ █ ███ ███████ ███████████ ███ █████ ███ █ █
█     █ █     █   █ █   █               █   █   █ █ █       █
█ ███ ███ ███ █ ███ █ ██████ ████ ███ █ ███ █ ███ █ █████ ███
█ █ █   █   █ █   █ █     █   █ █ █   █ █   █ █     █ █ █   █
███ ███ ███ █ █████████ █████ █ █ █████ █ █████ █████ █ ███ █
█       █   █     █                   █   █                 █
█ ███ ███ ███ █ █████ █████ █ █ █████ █ █ ████████ ████████ █
█   █       █ █ █   █   █   █ █     █ █ █ █   █       █     █
█████ █ █ █ ███████ █████ █████ ███ █████ █ █████ █████ █████
█     █ █ █   █   █   █     █   █ █     █   █         █   █ █
█████ ███ ███ █ ███ █ █████ █████ █████ █ █ █████ ███ ███ █ █
█ █   █   █         █         █     █   █ █ █ █   █       █ █
█ ███ ███ █ █████████ █ ███ █ ███ █ █ ███████ █ █████ ███ █ █
█ █   █   █ █         █ █   █     █ █   █ █   █     █   █ █ █
█ █ █████ █ █ ███████ █ █ █ █████ █ █ █ █ ███ █ █████████ █ █
█ █   █   █ █   █     █ █ █   █ █ █ █ █     █         █     █
█ ███████ █ ███ █ █████████ ███ █████████ █ ███ ███ █████ ███
█         █     █   █                 █   █ █     █   █     
███████████████████████████████████████████████████████████ 
