  ███████████████████
      █ █     █ █ █ █
███ ███ █████ █ █ █ █
█   █     █         █
█ ███ █████ █ ███ █ █
█ █ █       █ █ █ █ █
█ █ █ █ █████ █ ███ █
█   █ █   █     █ █ █
█ █ █ █████ █ ███ ███
█ █ █     █ █       █
███ █ █ ███ ███ █ ███
█     █   █ █   █ █ █
█ █ ███ ███ ███ █ █ █
█ █ █ █ █   █   █   █
█ ███ █ █ █ █████ █ █
█   █     █       █ █
███ ███ ███████ █████
█     █   █ █     █ █
█ █ █████ █ █ █████ █
█ █         █       
███████████████████ 
